1111111111111111111111111111111111
10000000E000000C00000C000000000001
1010011100111110101001000000010101
1110C1001010101C001001000000010101
100000100000C000000001000C000000C1
100010010000C000000010000100000011
1P00000000001000000000000C00000011
100000000C0010000011101111100000C1
1111111111111111111111111111111111
