1111111111111
1C010000C0001
1000011111001
1P0011E0C00O1
1111111111111